R 780 780

NO srcs/textures/north.xpm
SO srcs/textures/south.xpm
WE srcs/textures/west.xpm
EA srcs/textures/east.xpm

S srcs/textures/sprite.xpm
F 57,255,20
C 22,163,255

11111111111111111
10000020000000001
10000000000000001111111111111111111
10000000000000000000000000000000021
10000000000000001111111111111111111
10000000000000000000000000000000021
10000000000000001111111111111111111
10000000000200000000000000000000001
11111111100000000000000000000000001
12000000000000000000000000000000001
11111111100000000000000000000000001
12000000000000000000000000000000001
1111111110000000000000N000000000001
11111111111111111111111111111111111